################
#              #
# ####   #######
#    #   #     #
# S  #   #  ####
#####   ##     #
#       #  #####
# ########     #
#              #
################
