##############
#            #
# ######     #
# #    # ### #
# # ## # #S# #
# #    # # # #
# ######     #
#            #
##############
