####################
#                  #
# ######  ##########
# #    #  #        #
# # ## ###  ####  #
# #    #   # #  #  #
# ###### ### #  #  #
#        #   #  #S #
##########   ## ## #
#                  #
####################
