##########
#        #
#  ##  S #
#        #
#     ## #
#        #
##########
