############
#          #
# ######   #
#      #   #
# S    #   #
# ######   #
#          #
############
